###################
 #################
  ###############
   #############
    ###########
     #########
      #######
       #####
        ###
         #